WWWWWWWWWWWWWWWWWWWWWWWWWWWW
WZZZZZZZZZZZZWWZZZZZZZZZZZZW
WZWWWWZWWWWWZWWZWWWWWZWWWWZW
WXWWWWZWWWWWZWWZWWWWWZWWWWXW
WZWWWWZWWWWWZWWZWWWWWZWWWWZW 
WZZZZZZZZZZZZZZZZZZZZZZZZZZW
WZWWWWZWWZWWWWWWWWZWWZWWWWZW
WZWWWWZWWZWWWWWWWWZWWZWWWWZW
WZZZZZZWWZZZZWWZZZZWWZZZZZZW      
WWWWWWZWWWWWZWWZWWWWWZWWWWWW
YYYYYWZWWWWWZWWZWWWWWZWYYYYY
YYYYYWZWWZZZZZZZZZZWWZWYYYYY
WWWWWWZWWZWWWYYWWWZWWZWWWWWW
YYYYYYZZZZWYYYYYYWZZZZYYYYYY
WWWWWWZZZZWWWWWWWWZWWZWWWWWW
YYYYYWZWWZZZZZZZZZZWWZWYYYYY
YYYYYWZWWZWWWWWWWWZWWZWYYYYY
WWWWWWZWWZWWWWWWWWZWWZWWWWWW
WZZZZZZZZZZZZWWZZZZZZZZZZZZW
WZWWWWZWWWWWZWWZWWWWWZWWWWZW
WZWWWWZWWWWWZWWZWWWWWZWWWWZW
WXZZWWZZZZZZZZZZZZZZZZWWZZXW       
WWWZWWZWWZWWWWWWWWZWWZWWZWWW
WZZZZZZWWZZZZWWZZZZWWZZZZZZW
WZWWWWWWWWWWZWWZWWWWWWWWWWZW
WZWWWWWWWWWWZWWZWWWWWWWWWWZW
WZZZZZZZZZZZZZZZZZZZZZZZZZZW
WWWWWWWWWWWWWWWWWWWWWWWWWWWW