WWWWWWWWWWWWWWWWWWWWWWWWWWWW
WZZZZZZZZZZZZZZZZZZZZZZZZZZW
WZWWZWZWWWWWWWWWWWWWWZWZWWZW
WZZZZWZZZZZZZZZZZZZZZZWZZZZW
WXWWWWZWWWZWZWWZWZWWWZWWWWXW
WZZZZZZWWWZWZZZZWZWWWZZZZZZW
WZWZWWZZZZZWZWWZWZZZZZWWZWZW
WZWZWWZWZWZWZZZZWZWZWZWWZWZW
WZWZZZZWZZZWZWWZWZZZWZZZZWZW
WZWZWWZWZWZZZZZZZZWZWZWWZWZW
WZWZWWZWZWZWWZZWWZWZWZWWZWZW
WZWZZZZWZZZWWZZWWZZZWZZZZWZW
WZWZWWZWZWZWZZZZWZWZWZWWZWZW
WZWZWWZWZWZWZZZZWZWZWZWWZWZW
WZWZWWZWZWZWWWWWWZWZWZWWZWZW
WZWZWWZWZZZZZZZZZZZZWZWWZWZW
WZWZZZZWZWZZZZZZZZWZWZZZZWZW
WZWZWWZWZWZWZWWZWZWZWZWWZWZW
WZWZWWZWZWZWZZZZWZWZWZWWZWZW
WZWZZZZWZWZWZWWZWZWZWZZZZWZW
WZWZWWZWZWWWZZZZWWWZWZWWZWZW
WZWZWWZWZZZZZWWZZZZZWZWWZWZW
WXZZZZZWWWWWWWWWWWWWWZZZZZXW
WZWWWWZWWWWWWWWWWWWWWZWWWWZW
WZZZZWZZZZZZZZZZZZZZZZWZZZZW
WZWWZWZWWWWWWWWWWWWWWZWZWWZW
WZZZZZZZZZZZZZZZZZZZZZZZZZZW
WWWWWWWWWWWWWWWWWWWWWWWWWWWW