WWWWWWWWWWWWWWWWWWWWW
WXZZZZZZZZWZZZZZZZZXW
WZWWWZWWWZWZWWWZWWWZW
WZWWWZWWWZWZWWWZWWWZW
WZZZZZZZZZWZZZZZZZZZW
WZWWWZWZWWWWWZWZWWWZW
WZZZZZWZZZWZZZWZZZZZW
WWWWWZWWWZWZWWWZWWWWW
YYYYWZWZZZZZZZWZWYYYY
WWWWWZWZWWYWWZWZWWWWW
YYYYYXZZWYYYWZZXYYYYY
WWWWWZWZWYYYWZWZWWWWW
YYYYWZWZWWWWWZWZWYYYY
YYYYWZWZZZZZZZWZWYYYY
WWWWWZWZWWWWWZWZWWWWW
WZZZZZZZZZWZZZZZZZZZW
WZWWWZWWWZWZWWWZWWWZW
WZZZWZZZZZZZZZZZWZZZW
WWWZWZWZWWWWWZWZWZWWW
WZZZZZWZZZWZZZWZZZZZW
WZWWWWWWWZWZWWWWWWWZW
WXZZZZZZZZZZZZZZZZZXW
WWWWWWWWWWWWWWWWWWWWW